key	text	tooltip
#Loc;1;text/db/_land_units.loc		
land_units_onscreen_name_abb_arab_horse_skirmishers	Arab Horse Skirmishers	false
land_units_onscreen_name_abb_arab_javelinmen	Arab Javelinmen	false
land_units_onscreen_name_abb_turkmen_horsemen	Turkoman al-Jaridah	false
land_units_onscreen_name_abid_levy	Abid Levy	false
land_units_onscreen_name_abid_tribesmen	Abid Tribesmen	false
land_units_onscreen_name_abid_warriors	Abid Warriors	false
land_units_onscreen_name_afghan_skirmishers	Afghan Skirmishers	false
land_units_onscreen_name_afghan_mounted_skirmishers	Afghan Mounted Skirmishers	false
land_units_onscreen_name_ahdath_swordsmen	Ahdath Swordsmen	false
land_units_onscreen_name_alani_aldari_druzhina_cavalry	Alani Aldari Druzhina Cavalry	false
land_units_onscreen_name_alani_aldari_horse_archers	Alani Aldari Horse Archers	false
land_units_onscreen_name_alani_aldari_lancers	Alani Aldari Noble Lancers	false
land_units_onscreen_name_albanian_axe_mercenary	Albanian Militia Axemens	false
land_units_onscreen_name_albanian_spear_mercenary	Albanian Militia Spears	false
land_units_onscreen_name_andalusian_berber_cavalry	Andalusian Berber Cavalry	false
land_units_onscreen_name_andalusian_ghazi	Andalusian Ghazi	false
land_units_onscreen_name_andalusian_infantry	Andalusian Infantry	false
land_units_onscreen_name_andalusian_jund_swordsmen	Andalusian Heavy Swordsmen	false
land_units_onscreen_name_andalusian_knights	Andalusian Knights	false
land_units_onscreen_name_arab_cavalry	Arab Cavalry	false
land_units_onscreen_name_arab_desert_camel_archers	Arab Camel Archers	false
land_units_onscreen_name_arab_desert_camel_skirmishers	Arab Camel Skirmishers	false
land_units_onscreen_name_arab_desert_camel_warriors	Arab Camel Warriors	false
land_units_onscreen_name_arab_elite_cavalry	Arab Elite Cavalry	false
land_units_onscreen_name_arab_foot_warrior	Arab Foot Warriors	false
land_units_onscreen_name_arab_guard_cavalry	Arab Guard Cavalry	false
land_units_onscreen_name_arab_gunners	Arab Gunners	false
land_units_onscreen_name_arab_heavy_cavalry	Arab Heavy Cavalry	false
land_units_onscreen_name_arab_heavy_spears	Arab Heavy Spearmen	false
land_units_onscreen_name_arab_horsemen	Arab Horsemen	false
land_units_onscreen_name_arab_infantry	Arab Infantry	false
land_units_onscreen_name_arab_lancers	Arab Lancers	false
land_units_onscreen_name_arab_levy	Arab Levy	false
land_units_onscreen_name_arab_noble_cavalry	Arab Noble Cavalry	false
land_units_onscreen_name_arab_spears	Arab Spearmen	false
land_units_onscreen_name_arab_swords	Arab Swordsmen	false
land_units_onscreen_name_arm_maceman_dziaworner	Maceman Dziaworner	false
land_units_onscreen_name_arm_maceman_serzhantner	Maceman Serzhantner	false
land_units_onscreen_name_arm_swords_bourdjes	Sword Bourdjes	false
land_units_onscreen_name_arm_swords_dziaworner	Sword Dziaworner	false
land_units_onscreen_name_armenian_auxiliary	Armenian Spear Auxiliaries	false
land_units_onscreen_name_armenian_axemens	Armenian Axemen	false
land_units_onscreen_name_armenian_spearmen	Armenian Spearmen	false
land_units_onscreen_name_armenian_swordsmen	Armenian Swordsmen	false
land_units_onscreen_name_aus_burgerwehr_axemen	Burgerwehr Axemen	false
land_units_onscreen_name_aus_burgerwehr_halberdiers	Burgerwehr Halberdiers	false
land_units_onscreen_name_aus_burgerwehr_noble_halberdiers	Burgerwehr Noble Halberdiers	false
land_units_onscreen_name_aus_burgerwehr_swordsmen	Burgerwehr Swordsmen	false
land_units_onscreen_name_aus_dismounted_guardmen	Austrian Dismounted Guardsmen	false
land_units_onscreen_name_aus_dismounted_knights	Austrian Dismounted Knights	false
land_units_onscreen_name_aus_dismounted_ritter	Dismounted Ritter	false
land_units_onscreen_name_aus_foot_maa	Austrian Foot Men At Arms	false
land_units_onscreen_name_aus_fussknechte_swordsmen	Fussknechte Swordsmen	false
land_units_onscreen_name_aus_habsburg_foot_ritter	Habsburg Foot Ritter	false
land_units_onscreen_name_aus_habsburg_knights	Habsburg Knights	false
land_units_onscreen_name_aus_noble_glevener	Noble Glevener	false
land_units_onscreen_name_aus_pavisier_militia_spearmen	Pavisier Militia Spearmen	false
land_units_onscreen_name_aus_schutzen_spearmen	Schutzen Spearmen	false
land_units_onscreen_name_austrian_knight_mercenary	Austrian Knight Mercenaries	false
land_units_onscreen_name_awam_levy	Awam Levy	false
land_units_onscreen_name_ayy_nubian_archers	Nubian Archers	false
land_units_onscreen_name_ayy_nubian_levy	Nubian Levy	false
land_units_onscreen_name_ayy_nubian_skirmishers	Nubian Skirmishers	false
land_units_onscreen_name_ayy_nubian_spears	Nubian Spearmen	false
land_units_onscreen_name_ayy_nubian_swords	Nubian Swordsmen	false
land_units_onscreen_name_azerbaijani_archers	Azerbaijani Acrhers	false
land_units_onscreen_name_azerbaijani_savaran_cavalry	Azerbaijani Savaran Cavalry	false
land_units_onscreen_name_azerbaijani_spears	Azerbaijani Spearmen	false
land_units_onscreen_name_azerbaijani_swords	Azerbaijani Swordsmen	false
land_units_onscreen_name_basque_crossbowmen	Basque Crossbowmen	false
land_units_onscreen_name_basque_spear_militia	Basque Spear Militia	false
land_units_onscreen_name_basque_sword_militia	Basque Sword Militia	false
land_units_onscreen_name_bavarian_foot_knight_mercenary	Bavarian Foot Knight Mercenaries	false
land_units_onscreen_name_bavarian_knight_mercenary	Bavarian Knight Mercenaries	false
land_units_onscreen_name_berber_cavalry	Berber Cavalry	false
land_units_onscreen_name_berber_desert_camel_archers	Berber Camel Archers	false
land_units_onscreen_name_berber_desert_camel_warriors	Berber Camel Warriors	false
land_units_onscreen_name_berber_spears	Berber Spearmen	false
land_units_onscreen_name_boh_guardsmen	Bohemian Guardsmen	false
land_units_onscreen_name_bohemian_knight_mercenary	Bohemian Knight Mercenaries	false
land_units_onscreen_name_bosnian_axemen	Bosnian Axemen	false
land_units_onscreen_name_bosnian_guardmen	Bosnian Guardmen	false
land_units_onscreen_name_bosnian_halberdiers	Bosnian Halberdiers	false
land_units_onscreen_name_bosnian_heavy_swordsmen	Bosnian Heavy Swordsmen	false
land_units_onscreen_name_bosnian_militia_axemen	Bosnian Militia Axemen	false
land_units_onscreen_name_bosnian_noble_swordsmen	Bosnian Noble Swordsmen	false
land_units_onscreen_name_bosnian_swordmen	Bosnian Militia Swordsmen	false
land_units_onscreen_name_bosnian_swordsmen	Bosnian Swordsmen	false
land_units_onscreen_name_brabanzonen_knight_mercenary	Brabantian Knight Mercenaries	false
land_units_onscreen_name_bulg_archers_dogs	Militia Archers 	false
land_units_onscreen_name_bulg_axemen_mercenary	Bulgarian Axemen Mercenaries	false
land_units_onscreen_name_bulg_despot_billmen	Despot's Billmen	false
land_units_onscreen_name_bulg_despot_guards	Despot's Guards	false
land_units_onscreen_name_bulg_despot_nobles	Despot's Nobles	false
land_units_onscreen_name_bur_axemen_foot_knights	Guard Foot Knights	false
land_units_onscreen_name_bur_dismounted_noble_maa	Dismounted Noble Men At Arms	false
land_units_onscreen_name_bur_foot_knight_halberdiers	Foot Knight Halberdiers	false
land_units_onscreen_name_bur_guard_billmen	Guard Billmen	false
land_units_onscreen_name_bur_noble_halberdiers	Noble Halberdiers	false
land_units_onscreen_name_bur_noble_knights	Noble Knights	false
land_units_onscreen_name_bur_noble_mounted_sergeants	Noble Mounted Sergeants	false
land_units_onscreen_name_bur_spearmen_mercenary	Burgundian Mercenaries	false
land_units_onscreen_name_burgundian_knight_mercenary	Burgundian Knight Mercenaries	false
land_units_onscreen_name_byz_akolouthoi_spearmen	Akolouthoi Spearmen	false
land_units_onscreen_name_byz_alammanoi	Alammanoi	false
land_units_onscreen_name_byz_anglovarangoi_guard	Anglovarangoi Guard	false
land_units_onscreen_name_byz_archontopoulai	Archontopoulai	false
land_units_onscreen_name_byz_dismounted_latinkon	Dismounted Latinkon	false
land_units_onscreen_name_byz_hosarii	Hosarii	false
land_units_onscreen_name_byz_ippotoxotai	Ippotoxotai	false
land_units_onscreen_name_byz_italian_touphakyphoroi	Touphakyphoroi	false
land_units_onscreen_name_byz_kastrophylakes	Kastrophylakes Swordsmen	false
land_units_onscreen_name_byz_kastrophylakes_spears	Kastrophylakes Spearmen	false
land_units_onscreen_name_byz_latinkon_knights	Latinkon Knights	false
land_units_onscreen_name_byz_menaulatoi	Menaulatoi	false
land_units_onscreen_name_byz_scholarii	Scholarii	false
land_units_onscreen_name_byz_skythikon	Skythikon	false
land_units_onscreen_name_byz_spatharioi_tou_vasileos	Spatharioi tou Vasileos	false
land_units_onscreen_name_byz_spathatoi	Spathatoi 	false
land_units_onscreen_name_byz_spathatoi_spears	Spathatoi Spearmen	false
land_units_onscreen_name_byz_stratiotae	Stratiotae	false
land_units_onscreen_name_byz_vestiaritai_swordsmen	Vestiaritai	false
land_units_onscreen_name_byzantine_heavy_crossbowmen	Heavy Crossbowmen	false
land_units_onscreen_name_byzantine_militia_crossbowmen	Militia Crossbowmen	false
land_units_onscreen_name_caliphs_humat_swords	Caliph Humat Swordsmen	false
land_units_onscreen_name_calips_humat_maces	Caliph Humat Maceman	false
land_units_onscreen_name_canon_crossbowmen	Canons Of The Holy Sepulchre Crossbowmen	false
land_units_onscreen_name_canon_dismounted_knights	Canons Of The Holy Sepulchre Dismounted Knights	false
land_units_onscreen_name_canon_knights_men_at_arms	Canons Of The Holy Sepulchre Knight Men At Arms	false
land_units_onscreen_name_canon_noble_knights	Canons Of The Holy Sepulchre Noble Knights	false
land_units_onscreen_name_canon_spearmen_sergeants	Canons Of The Holy Sepulchre Spearmen Sergeant	false
land_units_onscreen_name_catalan_knights	Catalan Noble Knights	false
land_units_onscreen_name_catalan_spearmen	Catalan Spear Militia	false
land_units_onscreen_name_cherkess_cavalry	Cherkess Cavalry	false
land_units_onscreen_name_cherkess_javelinmen	Cherkess Javelinmen	false
land_units_onscreen_name_cherkess_horse_skirmishers	Cherkess Horse Skirmishers	false
land_units_onscreen_name_coptic_warriors	Coptic Warriors	false
land_units_onscreen_name_cuman_heavy_swordsmen	Cuman Heavy Swordsmen	false
land_units_onscreen_name_cuman_militia_swordsmen	Militia Swordsmen	false
land_units_onscreen_name_cuman_swordsmen	Cuman Swordsmen	false
land_units_onscreen_name_curteni_guardsmen	Curteni Guardsmen	false
land_units_onscreen_name_curteni_spearmen	Curteni Spearmen	false
land_units_onscreen_name_dan_axemen_huskarle_mercenary	Danish Axemen Huskarle Mercenaries	false
land_units_onscreen_name_dan_dismounted_guardmen	Dismounted Guardsmen	false
land_units_onscreen_name_dan_dismounted_huskarle	Dismounted Huskarle	false
land_units_onscreen_name_dan_dismounted_maa	Dismounted Men At Arms	false
land_units_onscreen_name_dan_nobles	Danish Nobles	false
land_units_onscreen_name_eng_dismounted_guardmen	Dismounted Guardsmen	false
land_units_onscreen_name_eng_dismounted_noble_guard	Dismounted Noble Guard	false
land_units_onscreen_name_eng_elit_knights	Elite Knights	false
land_units_onscreen_name_eng_elite_pikemen	Elite Pikemen	false
land_units_onscreen_name_eng_foot_knights	Foot Knights	false
land_units_onscreen_name_eng_men_at_arms	Men At Arms	false
land_units_onscreen_name_eng_nobles	English Nobles	false
land_units_onscreen_name_english_noble_knights	Noble Knights	false
land_units_onscreen_name_fre_dismounted_halberdiers	Dismounted Halberdiers	false
land_units_onscreen_name_french_dismounted_knights	Dismounted Knights	false
land_units_onscreen_name_french_dismounted_maa	Dismounted Men At Arms	false
land_units_onscreen_name_french_knight_mercenary	French Knight Mercenaries	false
land_units_onscreen_name_french_men_at_arms_mercenary	French Men At Arm Mercenaries	false
land_units_onscreen_name_french_noble_mercenary	French Noble Mercenaries	false
land_units_onscreen_name_gen_foot_knights	Foot Knights	false
land_units_onscreen_name_geo_khevsur_axemen	Khevsur Axemen	false
land_units_onscreen_name_geo_metsikhovne_axemen	Heavy Axemen	false
land_units_onscreen_name_georgian_auxiliary	Georgian Spear Auxiliaries	false
land_units_onscreen_name_german_axemen_mercenary	German Axemen Mercenaries	false
land_units_onscreen_name_german_foot_knight_mercenary	German Foot Knight Mercenaries	false
land_units_onscreen_name_german_guard_mercenary	German Guard Mercenaries	false
land_units_onscreen_name_german_sergeant_mercenary	German Sergeant Mercenaries	false
land_units_onscreen_name_harafisha_axemen	Harafisha Axemen	false
land_units_onscreen_name_hasham_berber_cavalry	Hasham Berber Cavalry	false
land_units_onscreen_name_hospitaller_brothers_guardmen	Hospitaller Brother Guardsmen	false
land_units_onscreen_name_hospitaller_knight_brothers_dismounted	Hospitaller Knight Brother Dismounted	false
land_units_onscreen_name_hospitaller_sergeant-brother_voulgiers	Hospitaller Sergeant Brother Voulgiers	false
land_units_onscreen_name_hospitaller_sergeant-brothers_spearmen	Hospitaller Sergeant Brother Spearmen	false
land_units_onscreen_name_hre_axe_sergeants	Axe Sergeants	false
land_units_onscreen_name_hre_dismounted_maa	Dismounted Men At Arms	false
land_units_onscreen_name_hre_dismounted_nobles	Dismounted Nobles	false
land_units_onscreen_name_hre_foot_knight_pikemen	Foot Knight Pikemen	false
land_units_onscreen_name_hre_foot_knights	Foot Knights	false
land_units_onscreen_name_hre_guisarmiers	Guisarmiers	false
land_units_onscreen_name_hre_halberdiers	Noble Halberdiers	false
land_units_onscreen_name_hre_noble_knights	Elite Soldritter	false
land_units_onscreen_name_hre_knights_dismounted	Dismounted Knights	false
land_units_onscreen_name_huffaz_spears	Huffaz Spearmen	false
land_units_onscreen_name_hun_axemen	Heavy Axemen	false
land_units_onscreen_name_hun_guardsmen	Guardsmen	false
land_units_onscreen_name_hun_nobles	Dismounted Knights	false
land_units_onscreen_name_iberian_dismounted_elit_mercenary	Iberian Dismounted Elit Mercenaries	false
land_units_onscreen_name_iberian_dismounted_guard_mercenary	Iberian Dismounted Guard Mercenaries	false
land_units_onscreen_name_iberian_halberdier_mercenary	Iberian Halberdier Mercenaries	false
land_units_onscreen_name_iberian_spearmen_mercenary	Iberian Spearmen Mercenaries	false
land_units_onscreen_name_iberian_swordsmen_mercenary	Iberian Swordsmen Mercenaries	false
land_units_onscreen_name_irish_axemen_mercenary	Irish Axemen Mercenaries	false
land_units_onscreen_name_irish_billmen_mercenary	Irish Billmen Mercenaries	false
land_units_onscreen_name_italian_dismounted_knight_mercenary	Italian Dismounted Knight Mercenaries	false
land_units_onscreen_name_italian_elit_foot_knight_mercenary	Italian Elit Foot Knight Mercenaries	false
land_units_onscreen_name_italian_foot_knight_mercenary	Italian Foot Knight Mercenaries	false
land_units_onscreen_name_italian_guard_mercenary	Italian Guard Mercenaries	false
land_units_onscreen_name_kapikulu_sipahi_nobles	Kapıkulu Noble Sipahi	false
land_units_onscreen_name_kapikulu_sipahi_sultan_guards	Kapıkulu Palace Bodyguards	false
land_units_onscreen_name_kapikulu_sipahis_heavy_lancers	Kapıkulu Elite Sipahi	false
land_units_onscreen_name_khorasani_muttawwi'a_cavalry	Khorasani Muttawwi'a Cavalry	false
land_units_onscreen_name_khorasani_muttawwi'a_lancers	Khorasani Muttawwi'a Lancers	false
land_units_onscreen_name_khorasani_muttawwi'a_swords	Khorasani Muttawwi'a Swordsmen	false
land_units_onscreen_name_khorasani_noble_cavalry	Khorasani Noble Cavalry	false
land_units_onscreen_name_khorasani_spears	Khorasani Muttawwi'a Spearmen	false
land_units_onscreen_name_khorasani_turkic_cavalry	Khorasani Turkic Cavalry	false
land_units_onscreen_name_khw_daylami_mercenaries_spears	Daylami Spearmen 	false
land_units_onscreen_name_kipchak_cavalry	Kıpchak Cavalry	false
land_units_onscreen_name_kurdish_cavalry	Kurdish Lancers	false
land_units_onscreen_name_kurdish_levy_spears	Kurdish Levy Spearmen	false
land_units_onscreen_name_kurdish_mounted_warriors	Kurdish Cavalry	false
land_units_onscreen_name_kurdish_spears	Kurdish Spearmen	false
land_units_onscreen_name_kurdish_warriors	Kurdish Swordsmen	false
land_units_onscreen_name_latin_dismounted_halberdier_mercenary	Latin Dismounted Halberdier Mercenaries	false
land_units_onscreen_name_latin_elit_knight_mercenary	Latin Elit Knight Mercenaries	false
land_units_onscreen_name_latin_foot_knight_mercenary	Latin Foot Knight Mercenaries	false
land_units_onscreen_name_lit_ducal_axemen	Ducal Axemen	false
land_units_onscreen_name_lit_ducal_halberdiers	Ducal Halberdiers	false
land_units_onscreen_name_lit_guardsmen	Lithuanian Guardsmen	false
land_units_onscreen_name_lombardian_knight_mercenary	Lombardian Knight Mercenaries	false
land_units_onscreen_name_lorraine_foot_knight_mercenary	Lorraine Foot Knight Mercenaries	false
land_units_onscreen_name_maghrebi_javelinmen	Maghrebi Javelinmen	false
land_units_onscreen_name_maghrebi_spears	Maghrebi Spearmen	false
land_units_onscreen_name_mk_fla_dismounted_count_retinue	Dismounted Count Retinue	false
land_units_onscreen_name_mk_fla_foot_knights	Foot Knights	false
land_units_onscreen_name_mk_jer_lazarus_foot_knights	St. Lazarus Foot Knights	false
land_units_onscreen_name_mk_jer_lazarus_maceman	St. Lazarus Maceman	false
land_units_onscreen_name_mk_jer_lazarus_mounted_sergeant	St. Lazarus Mounted Sergeant	false
land_units_onscreen_name_mk_jer_lazarus_noble_knights	St. Lazarus Noble Knights	false
land_units_onscreen_name_mk_jer_lazarus_sergeant_axemen	St. Lazarus Sergeant Axemen	false
land_units_onscreen_name_mk_jer_lazarus_sergeant_spearmen	St. Lazarus Sergeant Spearmen	false
land_units_onscreen_name_mk_mil_ducal_foot_knights	Ducal Foot Knights	false
land_units_onscreen_name_mk_rum_bulgarian_mercenary	Bulgarian Mercenaries	false
land_units_onscreen_name_mk_rum_ghazi_cavalry	Ghazi Cavalry	false
land_units_onscreen_name_mk_rum_handgunners	Handgunners	false
land_units_onscreen_name_caucasian_warriors	Caucasian Warriors	false
land_units_onscreen_name_mk_rum_turkoman_archers	Turkoman Archers	false
land_units_onscreen_name_mk_rum_turkoman_cavalry	Turkoman Cavalry	false
land_units_onscreen_name_mk_rum_turkoman_horse_archers	Turkoman Horse Archers	false
land_units_onscreen_name_mk_rum_turkoman_horse_skirmishers	Turkoman Horse Skirmishers	false
land_units_onscreen_name_mk_rum_turkoman_horsemen	Turkoman Noble Lancers	false
land_units_onscreen_name_mk_rum_turkoman_lancers	Turkoman Lancers	false
land_units_onscreen_name_mk_rum_turkoman_spears	Turkoman Spearmen	false
land_units_onscreen_name_mk_rum_turkoman_swords	Turkoman Swordsmen	false
land_units_onscreen_name_mk_rum_uc_suvarileri_lancers	Azerbaijani Ghulam Lancers	false
land_units_onscreen_name_mk_rum_uc_turkleri_cavalry	Azerbaijani Ghulam Cavalry	false
land_units_onscreen_name_mk_rum_vlach_mercenary	Vlach Mercenaries	false
land_units_onscreen_name_tatar_cavalry	Tatar Cavalry	false
land_units_onscreen_name_mk_tri_elector_foot_knights	Elector Foot Knights	false
land_units_onscreen_name_mk_zag_bow_sarawit_heroic	Bow Sarawit Heroic	false
land_units_onscreen_name_mk_zag_t1_hadar_axe	Hadar Axemen	false
land_units_onscreen_name_mk_zag_t1_hadar_swordsmen	Hadar Swordsmen	false
land_units_onscreen_name_mk_zag_t2_hadar_spears	Hadar Spearmen Heroic	false
land_units_onscreen_name_mk_zag_t2_highland_angada_spears	Highland Angada Spearmen	false
land_units_onscreen_name_mk_zag_t2_jan_gunner	Jan Gunners	false
land_units_onscreen_name_mk_zag_t4_balage_levy	Balage Levy	false
land_units_onscreen_name_moldavian_spears	Moldavian Spearmen	false
land_units_onscreen_name_mon_arab_auxiliaries	Arab Auxiliaries	false
land_units_onscreen_name_mon_armenian_auxiliaries	Armenian Auxiliaries	false
land_units_onscreen_name_mon_caucasian_auxiliaries	Caucasian Auxiliaries	false
land_units_onscreen_name_mon_chagatai_lancers	Chagatai Lancers	false
land_units_onscreen_name_mon_georgian_footmen	Georgian Footmen	false
land_units_onscreen_name_mon_kipchak_horse_archers	Kıpchak Horse Archers	false
land_units_onscreen_name_mon_kipchak_lancers	Kıpchak Lancers	false
land_units_onscreen_name_mon_kipchak_noble_horse_archers	Kıpchak Noble Horse Archers	false
land_units_onscreen_name_mon_kipchak_spearmen	Kıpchak Spearmen	false
land_units_onscreen_name_mon_nogay_horse_archers	Nogay Horse Archers	false
land_units_onscreen_name_mon_persian_auxiliaries	Persian Auxiliaries	false
land_units_onscreen_name_mon_rus_auxiliaries	Rus Auxiliaries	false
land_units_onscreen_name_mon_turco_mongol_horse_archers	Turco-Mongol Horse Archers	false
land_units_onscreen_name_mon_turcoman_lancers	Turkoman Lancers	false
land_units_onscreen_name_mon_turcoman_horsemen	Turkoman Cavalry	false
land_units_onscreen_name_mon_war_elephants_handgunners	Handgunner War Elephants	false
land_units_onscreen_name_mon_war_elephants_hathnal_cannon	Hathnal Canon War Elephants	false
land_units_onscreen_name_mon_war_elephants_naphta	Naphta War Elephants	false
land_units_onscreen_name_mon_wild_war_elephants	Wild War Elephants Mercenaries	false
land_units_onscreen_name_Mozarab_spears	Mozarab Spearmen	false
land_units_onscreen_name_murabit_tribesmen	Murabit Tribesmen	false
land_units_onscreen_name_nor_armoured_halberdiers	Armoured Halberdiers	false
land_units_onscreen_name_nor_armoured_pikemen	Armoured Pikemen	false
land_units_onscreen_name_nor_handgunners	Handgunners	false
land_units_onscreen_name_nor_landevern_axemen	Landevern Axemen	false
land_units_onscreen_name_nor_mounted_crossbowmen	Mounted Crossbows	false
land_units_onscreen_name_pecheneg_bowmens	Pecheneg Bowmens	false
land_units_onscreen_name_pecheneg_cavalry	Pecheneg Cavalry	false
land_units_onscreen_name_pecheneg_horse_archers	Pecheneg Horse Archers	false
land_units_onscreen_name_perisan_elite_cavalry	Persian Elite Cavalry	false
land_units_onscreen_name_persian_axemen	Persian Axemen	false
land_units_onscreen_name_persian_crosbowmen	Persian Crossbowmen	false
land_units_onscreen_name_persian_foot_swordsmen	Persian Foot Swordsmen	false
land_units_onscreen_name_persian_infantry	Persian Infantry	false
land_units_onscreen_name_persian_lancers	Persian Lancers	false
land_units_onscreen_name_persian_tufangchiyan	Persian Handgunners	false
land_units_onscreen_name_pol_guardsmen	Polish Guardsmen	false
land_units_onscreen_name_poulain_guard	Poulain Guard	false
land_units_onscreen_name_poulain_knights_voulgiers	Poulain Knight Voulgiers	false
land_units_onscreen_name_poulain_maceman	Poulain Macemen	false
land_units_onscreen_name_poulain_swordsmen	Poulain Swordsmen	false
land_units_onscreen_name_rus_boyar_cavalry	Boyar Cavalry	false
land_units_onscreen_name_rus_boyar_heavy_axemen	Boyar Heavy Axemen	false
land_units_onscreen_name_rus_druzina_halberdier	Druzina Halberdier	false
land_units_onscreen_name_rus_dvor_druzina	Dvor Druzina 	false
land_units_onscreen_name_rus_dvor_spearmen	Dvor Spearmen	false
land_units_onscreen_name_rus_dvor_swordsmen	Dvor Swordsmen	false
land_units_onscreen_name_rus_dvor_warrior_mercenary	Dvor Axemen	false
land_units_onscreen_name_rus_guardmen	Bogatyri Axemen	false
land_units_onscreen_name_rus_handgunners	Gunners	false
land_units_onscreen_name_rus_knyaz_bodyguard	Knyaz Noble Guard	false
land_units_onscreen_name_rus_skirmisher_cavalry	Rus Skirmisher Cavalry	false
land_units_onscreen_name_rus_suzdal_axemen	Suzdal Axemen	false
land_units_onscreen_name_rus_suzdal_halberdier	Suzdal Halberdier	false
land_units_onscreen_name_russian_guard_heavy_axemen	Ratniki Heavy Axemen	false
land_units_onscreen_name_ruthenian_axemen	Ruthenian Axemen	false
land_units_onscreen_name_ruthenian_warriors	Ruthenian Warriors	false
land_units_onscreen_name_saxon_archers	Saxon Archers	false
land_units_onscreen_name_saxon_axe_sergeants	Saxon Axe Sergeants	false
land_units_onscreen_name_saxon_axemen	Saxon Axemen	false
land_units_onscreen_name_saxon_count_retinue_knights	Saxon Count Retinue Knights	false
land_units_onscreen_name_saxon_crosbowmen	Saxon Crossbowmen	false
land_units_onscreen_name_saxon_dismaunted_men_at_arms	Saxon Dismounted Men At Arms	false
land_units_onscreen_name_saxon_dismounted_count_retinue	Saxon Dismounted Count Retinue	false
land_units_onscreen_name_saxon_dismounted_knights	Saxon Dismounted Knights	false
land_units_onscreen_name_saxon_foot_knights	Saxon Foot Knights	false
land_units_onscreen_name_saxon_goedendag	Saxon Goedendag	false
land_units_onscreen_name_saxon_guisarmiers	Saxon Guisarmiers	false
land_units_onscreen_name_saxon_halberdiers	Saxon Halberdiers	false
land_units_onscreen_name_saxon_handgunners	Saxon Handgunners	false
land_units_onscreen_name_saxon_knight_halberdiers	Saxon Knight Halberdiers	false
land_units_onscreen_name_saxon_knights	Saxon Knights	false
land_units_onscreen_name_saxon_mounted_crossbows	Saxon Mounted Crossbows	false
land_units_onscreen_name_saxon_noble_knights	Saxon Noble Knights	false
land_units_onscreen_name_saxon_pikemen	Saxon Pikemen	false
land_units_onscreen_name_saxon_scouts	Saxon Scouts	false
land_units_onscreen_name_saxon_spear	Saxon Spearmen	false
land_units_onscreen_name_saxon_swordsmen	Saxon Swordsmen	false
land_units_onscreen_name_scottish_axemen_militia	Scottish Axemen Militia	false
land_units_onscreen_name_scottish_billmen	Scottish Billmen	false
land_units_onscreen_name_scottish_cavalry	Scottish Cavalry	false
land_units_onscreen_name_scottish_crossbowmen	Scottish Crossbowmen	false
land_units_onscreen_name_scottish_flailmen	Scottish Flailmen	false
land_units_onscreen_name_scottish_goedendags	Scottish Goedendags	false
land_units_onscreen_name_scottish_haberdier_sergeant	Scottish Halberdier Sergeants	false
land_units_onscreen_name_scottish_handgunners	Scottish Handgunners	false
land_units_onscreen_name_scottish_javelinmen	Scottish Javelinmen	false
land_units_onscreen_name_scottish_militia_halberd	Scottish Militia Halberd	false
land_units_onscreen_name_scottish_mounted_crossbowmen	Scottish Mounted Crossbowmen	false
land_units_onscreen_name_scottish_mounted_sergeants	Scottish Mounted Sergeants	false
land_units_onscreen_name_scottish_mounted_skirmishers	Scottish Mounted Skirmishers	false
land_units_onscreen_name_scottish_pikemen_sergant	Scottish Pikemen Sergeants	false
land_units_onscreen_name_scottish_spear_militia	Scottish Spear Militia	false
land_units_onscreen_name_scottish_spear_sergeants	Scottish Spear Sergeants	false
land_units_onscreen_name_scottish_sword_militia	Scottish Sword Militia	false
land_units_onscreen_name_serb_axemen_mercenary	Serbian Axemen Mercenaries	false
land_units_onscreen_name_serb_militia_mercenary	Serbian Militia Mercenaries	false
land_units_onscreen_name_serb_militia_swordsmen	Militia Swordsmen	false
land_units_onscreen_name_serb_vlastelicici_halberdiers	Vlastelicici Halberdiers	false
land_units_onscreen_name_serb_vojnici_guard_axemen	Vojnici Guardsmen	false
land_units_onscreen_name_serb_vojnici_guardmen	Vojnici Nobles	false
land_units_onscreen_name_serb_vojnici_swordsmen	Vojnici Swordsmen	false
land_units_onscreen_name_shanbakara_footmen	Shanbakara Footmen	false
land_units_onscreen_name_shanbakara_spears	Shanbakara Spearmen	false
land_units_onscreen_name_sicilian_dismounted_count_retinue	Sicilian Dismounted Count Retinue	false
land_units_onscreen_name_sicilian_dismounted_foot_knights	Sicilian Dismounted Foot Knights	false
land_units_onscreen_name_sicilian_noble_knights	Sicilian Noble Knights	false
land_units_onscreen_name_sicilian_spear_mercenary	Sicilian Spear Mercenaries	false
land_units_onscreen_name_silahtar_guard	Kapıkulu Sultan's Bodyguards	false
land_units_onscreen_name_silesia_knight_mercenary	Silesian Knight Mercenaries	false
land_units_onscreen_name_silesia_noble_knight_mercenary	Silesian Noble Knight Mercenaries	false
land_units_onscreen_name_slavic_levy	Slavic Levy	false
land_units_onscreen_name_slavic_levy_spear	Slavic Levy Spearmen	false
land_units_onscreen_name_spanish_dismounted_monteros_de_espinosa	Spanish Dismounted Monteros De Espinosa	false
land_units_onscreen_name_spanish_dismounted_peones	Spanish Dismounted Peones	false
land_units_onscreen_name_spanish_dismounted_peones_de_guard	Spanish Dismounted Peones De Guard	false
land_units_onscreen_name_spanish_halberd_maa_mercenary	Spanish Halberd Men At Arm Mercenaries	false
land_units_onscreen_name_spanish_hallebardiers_mercenary	Spanish Guard Halberdier Mercenaries	false
land_units_onscreen_name_spanish_noble_hidalgos	Spanish Noble Hidalgos	false
land_units_onscreen_name_spanish_pikemen_mercenary	Spanish Pikemen Mercenaries	false
land_units_onscreen_name_sudanese_noble_archers	Sudanese Noble Archers	false
land_units_onscreen_name_sweden_archer	Archers	false
land_units_onscreen_name_sweden_axe	Axemen	false
land_units_onscreen_name_sweden_axemen	Axemen	false
land_units_onscreen_name_sweden_axemen_militia	Militia Axemens	false
land_units_onscreen_name_sweden_dismounted_maa	Dismounted Men At Arms	false
land_units_onscreen_name_sweden_dismounted_maa_mercenary	Sweden Dismounted Men At Arm Mercenaries	false
land_units_onscreen_name_sweden_elite_knights	Elite Knights	false
land_units_onscreen_name_sweden_foot_knights	Foot Knights	false
land_units_onscreen_name_sweden_guisarmiers	Guisarmiers	false
land_units_onscreen_name_sweden_gunners	Gunners	false
land_units_onscreen_name_sweden_halberdiers	Halberdiers	false
land_units_onscreen_name_sweden_heavy_huskarls	Heavy Huskarls	false
land_units_onscreen_name_sweden_knights	Knights	false
land_units_onscreen_name_sweden_levy_axemens	Levy Axemen	false
land_units_onscreen_name_sweden_mounted_crosbowmen	Mounted Crossbows	false
land_units_onscreen_name_sweden_mounted_sergeant	Mounted Sergeant	false
land_units_onscreen_name_sweden_noble_cavalry	Noble Cavalry	false
land_units_onscreen_name_sweden_noble_knights	Noble Knights	false
land_units_onscreen_name_sweden_pikemen	Pikemen	false
land_units_onscreen_name_sweden_sergeants	Sergeants	false
land_units_onscreen_name_sweden_spear_militia	Spear Militia	false
land_units_onscreen_name_swiss_gunners_mercenary	Swiss Gunner Mercenaries	false
land_units_onscreen_name_swiss_noble_halberdier_mercenary	Swiss Noble Halberdier Mercenaries	false
land_units_onscreen_name_swiss_warrior_mercenary	Swiss Warrior Mercenaries	false
land_units_onscreen_name_tatar_lancers	Tatar Lancers	false
land_units_onscreen_name_tatar_noble_lancers	Tatar Noble Lancers	false
land_units_onscreen_name_tazik_levy	Afghan Militia	false
land_units_onscreen_name_tazik_levy_spears	Afghan Spear Militia	false
land_units_onscreen_name_teu_dismounted_grandmaster	Dismounted Grandmaster	false
land_units_onscreen_name_teu_high_axemen	High Axemen	false
land_units_onscreen_name_teu_knight_grandmaster	Knight Grandmaster	false
land_units_onscreen_name_teu_noble_knight_ritterbruder	Elite Ritterbrüder 	false
land_units_onscreen_name_thagri_spears	Thagri Spearmen	false
land_units_onscreen_name_turco-persian_footmen	Turco-Persian Footmen	false
land_units_onscreen_name_turkic_levy	Turkic Tribe Levy	false
land_units_onscreen_name_turkic_levy_archers	Turkic Tribe Levy Archers	false
land_units_onscreen_name_turkoman_azerbaijani_cavalry	Turkoman Azerbaijani Horse Archers	false
land_units_onscreen_name_turkoman_azerbaijani_lancers	Turkoman Azerbaijani Lancers	false
land_units_onscreen_name_turkoman_azerbaijani_noble_cavalry	Turkoman Azerbaijani Cavalry	false
land_units_onscreen_name_venetian_mercenary	Venetian Mercenaries	false
land_units_onscreen_name_vlach_boyar_cavalry	Boyar Cavalry	false
land_units_onscreen_name_vlach_boyar_noble_cavalry	Boyar Noble Cavalry	false
land_units_onscreen_name_vlach_halberdier_mercenary	Vlach Halberdier	false
land_units_onscreen_name_vlach_mounted_skirmishers	Vlach Mounted Skirmishers	false
land_units_onscreen_name_vlach_spear_mercenary	Vlach Spear	false
land_units_onscreen_name_vlach_warrior_mercenary	Vlach Warrior	false
land_units_onscreen_name_voinici_macemans	Voinici Macemen	false
land_units_onscreen_name_voinici_swordsmen	Voinici Swordsmen	false
land_units_onscreen_name_volga_chirmesh_swordsmen	Chirmesh Swordsmen	false
land_units_onscreen_name_volga_siberian_axemen	Siberian Axemen	false
land_units_onscreen_name_volga_tribal_swordsmen	Tribal Swordsmen	false
land_units_onscreen_name_voynik_axemen	Voynik Axemen	false
land_units_onscreen_name_voynik_swordsmen	Voynik Swordsmen	false
land_units_onscreen_name_yeniceri_axemen	Yeniçeri Axemen	false
land_units_onscreen_name_yeniceri_guard_billmen	Yeniçeri Guard Billmen	false
land_units_onscreen_name_yeniceri_guards	Yeniçeri Guards	false
land_units_onscreen_name_yeniceri_handgunners	Yeniçeri Gunners	false
land_units_onscreen_name_yeniceri_pikemen	Yeniçeri Pikemen	false
land_units_onscreen_name_yeniceri_spearmen	Yeniçeri Spearmen	false
land_units_onscreen_name_yeniceri_warrior	Yeniçeri Swordsmen	false
land_units_onscreen_name_zirhli_yeniceri_guardmen	Zırhlı Yeniçeri Guardsmen	false
land_units_onscreen_name_zirhli_yeniceri_handgunners	Zırhlı Yeniçeri Handgunners	false
land_units_onscreen_name_zirhli_yeniceri_spears	Zırhlı Yeniçeri Spearmen	false
land_units_onscreen_name_zirhli_yeniceri_warrior	Zırhlı Yeniçeri Warriors	false
land_units_onscreen_name_african_elephants	Archer African War Elephants	false
land_units_onscreen_name_african_tower_war_elephants	Javelin African War Elephants	false
land_units_onscreen_name_mujahideen_jinetes	Mujahideen Jinetes	false
land_units_onscreen_name_muwalladun_knights	Muwalladun Knights	false
land_units_onscreen_name_mujahideen_cavalry	Mujahideen Cavalry	false
land_units_onscreen_name_andalusian_heavy_spearmen	Andalusian Heavy Spearmen	false
land_units_onscreen_name_andalusian_spearmen	Andalusian Spearmen	false
land_units_onscreen_name_alb_albanian_axemen	Luftetar Sepate	false
land_units_onscreen_name_alb_albanian_guards	Rojet me Sepate	false
land_units_onscreen_name_alb_albanian_gunners	Qites me Pushke	false
land_units_onscreen_name_alb_albanian_militia_archers	Harketaret e Milicise	false
land_units_onscreen_name_alb_albanian_militia_skirmishers	Shtixhinjte e Milicise	false
land_units_onscreen_name_alb_albanian_horse_skirmishers	Kaloresit e Shtizes	false
land_units_onscreen_name_albanian_archer_mercenary	Albanian Militia Archers	false
land_units_onscreen_name_alan_lancers	Alani Aldari Lancers	false
land_units_onscreen_name_siege_levies_swords	Siege Levie Swords	false
land_units_onscreen_name_tserig_infantry	Tserig Infantry	false
land_units_onscreen_name_balkan_levy_spearmen	Balkan Levy Spearmen	false
land_units_onscreen_name_caucasian_levy_spearmen	Caucasian Spearmen	false
land_units_onscreen_name_india_levy_spearmen	Dhanuks Spearmen	false
land_units_onscreen_name_persian_levy_spearmen	Persian Spear Militia	false
land_units_onscreen_name_rus_levy_spearmen	Rus Levy Spearmen	false
land_units_onscreen_name_bulgarian_brigands	Bulgarian Brigands	false
land_units_onscreen_name_kurdish_axemen	Kurdish Axemen	false
land_units_onscreen_name_persian_ghazi	Persian Ghazi	false
land_units_onscreen_name_saxon_huscarls	Saxon Huscarls	false
land_units_onscreen_name_berendei_horse_archers	Berendei Horse Archers	false
land_units_onscreen_name_croat_brigands	Croatian Brigands	false
land_units_onscreen_name_persian_heavy_axemen	Persian Heavy Axemen	false
land_units_onscreen_name_slavic_axemen_auxiliary	Slavic Axemen	false
land_units_onscreen_name_afgan_kabuli_axemen	Afghan Axemen	false
land_units_onscreen_name_hindu_longbowmen	Hindu Longbowmen	false
land_units_onscreen_name_khalaj_turkish_bowmen	Khalaj Turkish Bowmen	false
land_units_onscreen_name_khalaj_turkish_cavalry	Khalaj Turkish Horse Archers	false
land_units_onscreen_name_tajik_urban_militia	Tajik Militia	false
land_units_onscreen_name_armenian_heavy_axemen	Armenian Heavy Axemen	false
land_units_onscreen_name_hindu_levy_spearmen	Hindu Levy Spearmen	false
land_units_onscreen_name_voynuk_infantry	Voynuk Guardsmen	false
land_units_onscreen_name_nafta_throwers_mercenary	Mercenary Nafta Throwers	false
land_units_onscreen_name_tajik_spear_militia	Tajik Spear Militia	false
land_units_onscreen_name_turkic_tribes_lancer	Turkic Tribe Lancers	false
land_units_onscreen_name_turkic_tribes_horsemen	Turkic Tribe Horsemen	false
land_units_onscreen_name_bohemia_foot_knight_guardsmen	Bohemian Foot Knight Guardsmen	false
land_units_onscreen_name_byz_varangian	Varangian Warriors	false
land_units_onscreen_name_georgian_spearmen_mercenary	Mercenary Georgian Spearmen	false
land_units_onscreen_name_french_elite_knights_mercenary	French Elite Knights Mercenaries	false
land_units_onscreen_name_hre_elite_knight_mercenary	German Elite Knights Mercenaries	false
land_units_onscreen_name_hospitaller_knights_mercenary	Hospitaller Knights Mercenaries	false
land_units_onscreen_name_templar_knights_mercenary	Templar Knights Mercenaries	false
land_units_onscreen_name_uzes_noble_cavalry	Uz Noble Cavalry	false
land_units_onscreen_name_uzes_cavalry	Uz Cavalry	false
land_units_onscreen_name_hre_heavy_infantry	Heavy Infantry	false
land_units_onscreen_name_hre_nobles	Nobles	false
land_units_onscreen_name_hre_spearmen	Spearmen	false
land_units_onscreen_name_hre_sergeant_axemen	Axemens	false
land_units_onscreen_name_hre_pavisier_swordsmen	Pavisier Swordsmen	false
land_units_onscreen_name_eng_pikemen	Pikemen	false
land_units_onscreen_name_mk_merc_tur_t1_swordsmen	Mercenary Turkoman Swordsmen (Early)	false
land_units_onscreen_name_mk_merc_tur_t1_spearmen	Mercenary Turkoman Spearmen (Early)	false
land_units_onscreen_name_kurdish_horse_skirmishers	Kurdish Mounted Skirmishers	false
land_units_onscreen_name_mk_abb_t1_turkoman_medium_horse_archer	Turkoman Jund Horse Archers (Early)	true
land_units_onscreen_name_mk_ayy_t2_turcoman_jarida	Turkoman at-Ta'a (High)	true
land_units_onscreen_name_mk_ayy_t3_turcoman_jarida	Turkoman at-Ta'a (Late)	true
land_units_onscreen_name_mk_ayy_t1_turkoman_jarida	Turkoman at-Ta'a (Early)	true
land_units_onscreen_name_mk_khw_t1_turcoman_cavalry	Turkoman Cavalry (Early)	true
land_units_onscreen_name_mk_mon_t3_ilkhan_turcoman_cavalry	Turkoman Horse Archer	true
land_units_onscreen_name_mk_abb_t1_turcoman_jarida	Turkoman at-Ta'a (Early)	true
land_units_onscreen_name_mk_abb_t3_turcoman_jarida	Turkoman at-Ta'a (Late)	true
land_units_onscreen_name_mk_abb_t2_turcoman_jarida	Turkoman at-Ta'a (High)	true
land_units_onscreen_name_early_persian_cavalry	Early Persian Cavalry	false
land_units_onscreen_name_persian_horse_skirmishers	Persian Mounted Skirmishers	false
land_units_onscreen_name_persian_horsemen	Persian Horsemen	false
land_units_onscreen_name_qizilbash_turkoman_cavalry	Qizilbash Turkoman Cavalry	false
land_units_onscreen_name_qizilbash_turkoman_archers	Qizilbash Turkoman Archers	false
land_units_onscreen_name_qizilbash_turkoman_spearmen	Qizilbash Turkoman Spearmen	false
land_units_onscreen_name_qizilbash_turkoman_swordsmen	Qizilbash Turkoman Swordsmen	false
land_units_onscreen_name_mk_khw_t3_qizilbash_lancers	Qizilbash Turkoman Lancers	true
land_units_onscreen_name_mk_khw_t3_qizilbash	Qizilbash Turkoman Horse Archers	true
land_units_onscreen_name_daylami_horse_skirmishers	Daylami Mounted Skirmishers	false
land_units_onscreen_name_mk_ghu_t1_khalaj_cavalry	Khalaj Turkish Cavalry (Early)	true
land_units_onscreen_name_mk_ghu_t2_khalaj_cavalry	Khalaj Turkish Cavalry (High)	true
land_units_onscreen_name_mk_ghu_t3_khalaj_cavalry	Khalaj Turkish Cavalry (Late)	true
land_units_onscreen_name_azerbaijani_turkoman_archers	Turkoman Azerbaijani Archers	false
land_units_onscreen_name_azerbaijani_turkoman_spears	Turkoman Azerbaijani Spears	false
land_units_onscreen_name_azerbaijani_turkoman_warrior	Turkoman Azerbaijani Warriors	false
land_units_onscreen_name_kurdish_skirmishers	Kurdish Skirmishers	false
land_units_onscreen_name_daylami_cavalry	Daylami Cavalry	false
land_units_onscreen_name_daylami_infantry	Daylami Swordsmen	false
land_units_onscreen_name_daylami_levy_spearmen	Daylami Levy Spearmen	false
land_units_onscreen_name_georgian_swordsmen	Georgian Sword Auxiliaries	false
land_units_onscreen_name_armenia_swordsmen	Armenian Sword Auxiliaries	false
land_units_onscreen_name_hre_longbowmen	Longbowmens	false
land_units_onscreen_name_yaya_swordsmen	Yaya Swordsmen	false
land_units_onscreen_name_musellem_lancers	Müsellem Lancers	false
land_units_onscreen_name_mk_rum_t2_yaya_spearmen	Yaya Spearmen (High)	true
land_units_onscreen_name_mk_rum_t2_musellem	Müsellem Cavalry	true
land_units_onscreen_name_hospitaller_sergeant-brothers_swordsmen	Hospitaller Sergeant Brother Swordsmen	false
land_units_onscreen_name_mk_rum_t3_kapikulu_heavy_infantry	Kapıkulu Infantry	false
land_units_onscreen_name_mercenary_cuman_spearmen	Mercenary Cuman Spearmen	false
land_units_onscreen_name_mercenary_cuman_tribesmen	Mercenary Cuman Tribesmen	false
land_units_onscreen_name_mk_rum_t2_askeri_lancers	Askeri Noble Lancers  	false
land_units_onscreen_name_mk_rum_t3_askeri_lancers	Askeri Elite Lancers 	false
land_units_onscreen_name_mk_rum_t3_eflak	Eflak Crossbowmen	false
land_units_onscreen_name_basibozuks	Basibozuks	false
land_units_onscreen_name_basibozuks_cavalry	Basibozuks Cavalry	false
land_units_onscreen_name_mon_vlach_auxiliaries	Vlach Spear Auxiliaries	false
land_units_onscreen_name_mercenary_armenia_swordsmen	Mercenary Armenian Swordsmen	false
land_units_onscreen_name_armenian_azat_archers	Armenian Azat Archers	false
land_units_onscreen_name_armenian_nakharar_knight	Armenian Nakharar Knights	false
land_units_onscreen_name_armenian_knights	Armenian Knights	false
land_units_onscreen_name_armenian_mounted_serjeants	Armenian Mounted Sergeants	false
land_units_onscreen_name_kipchak_swordsmen	Kıpchak Swordsmen	false
land_units_onscreen_name_swiss_voulgiers	Swiss Voulgiers	false
land_units_onscreen_name_swiss_guardsmen	Swiss Guardsmen	false
land_units_onscreen_name_swiss_pikemen	Swiss Pikemen	false
land_units_onscreen_name_swiss_goedendag	Swiss Goedendag	false
land_units_onscreen_name_mongol_foot_soldiers	Mongol Foot Soldiers	false
land_units_onscreen_name_mongol_footmen	Mongol Footmen	false
land_units_onscreen_name_mongol_foot_archers	Mongol Foot Archers	false
land_units_onscreen_name_mk_mon_t1_ilkhan_horse_archers	Mongol Horse Archers (Early)	true
land_units_onscreen_name_persian_militia	Persian Militia	false
land_units_onscreen_name_mongol_cavalry	Mongol Cavalry	false
land_units_onscreen_name_mk_mon_t3_ilkhan_chagatai_cavalry	Chagatai Horse Archers	false
land_units_onscreen_name_mk_mon_t3_ilkhan_turcoman_cavalry	Turkoman Horse Archers	true
land_units_onscreen_name_chagatai_cavalry	Chagatai Cavalry	false
land_units_onscreen_name_afghan_cavalry	Afghan Cavalry	false
land_units_onscreen_name_saxon_sergeants	Saxon Sergeants	false
land_units_onscreen_name_saxon_militia_axemen	Saxon Militia Axemen	false
land_units_onscreen_name_saxon_militia_spearmen	Saxon Militia Spearmen	false
land_units_onscreen_name_caucasian_heavy_axemen	Caucasian Heavy Axemen	false
