key	text	tooltip
#Loc;1;text/db/fote_desert_land_units.loc		
land_units_onscreen_name_att_des_amazigh_lancers	Equites Mauri Nomades	true
land_units_onscreen_name_att_des_amazigh_raiders	Equites Numidarum	true
land_units_onscreen_name_att_des_amazigh_spearmen	Lanciarii Mauri	true
land_units_onscreen_name_att_des_arabic_horsemen	Fawaris Al-Jund	true
land_units_onscreen_name_att_des_armoured_camel_warriors	Rammah Al-Ibil Al-Jund	true
land_units_onscreen_name_att_des_camel_lancers	Rammah Al-Ibil Al-Badawi	true
land_units_onscreen_name_att_des_camel_warriors	Dromedarii Mauri	true
land_units_onscreen_name_att_des_desert_bowmen	Rumat Al-Arab	true
land_units_onscreen_name_att_des_desert_chieftain	Fawaris Al-Ashraf	true
land_units_onscreen_name_att_des_desert_hurlers	Maqali Al-Arab	true
land_units_onscreen_name_att_des_desert_legionary_defectors	Asyaf Al-Jund	true
land_units_onscreen_name_att_des_desert_levy	Rammah Al-Ghawgha	true
land_units_onscreen_name_att_des_desert_mounted_javelinmen	Sa'ba Afras Haqqalat	true
land_units_onscreen_name_att_des_desert_mounted_skirmishers	Fawaris Al-Bedawi	true
land_units_onscreen_name_att_des_desert_palatina_defectors	Asyaf Al-Murtaziqa	true
land_units_onscreen_name_att_des_desert_raiders	Fawaris Al-Arab	true
land_units_onscreen_name_att_des_desert_spears	Rammah Al-Arab	true
land_units_onscreen_name_att_des_desert_tribesmen	Asyaf Al-Arab	true
land_units_onscreen_name_att_des_desert_warlord	Equites Sacer-Comitati Maurorum	true
land_units_onscreen_name_att_des_elite_nubian_archers	Darabawiat za-Noba	true
land_units_onscreen_name_att_des_es_abunas_guard	Sab'a Afras Negusawi	true
land_units_onscreen_name_att_des_es_adana_marksmen	Kalabat za-Noba	true
land_units_onscreen_name_att_des_es_adana_trackers	Kalabat-a Harb	true
land_units_onscreen_name_att_des_es_afar_camel_riders	Gamalawiat za-Haqqalat	true
land_units_onscreen_name_att_des_es_afar_raidmasters	Sab'a 'Asyaf za-Hawari	true
land_units_onscreen_name_att_des_es_afar_swordsmen	Sab'a 'Asyaf za-Habasa	true
land_units_onscreen_name_att_des_es_al_dawser	Fawaris Al-Dawser	true
land_units_onscreen_name_att_des_es_al_rahrain	Asyaf Al-Wad'ai	true
land_units_onscreen_name_att_des_es_al_shahba	Fawaris Al-Shabha	true
land_units_onscreen_name_att_des_es_almaqahs_lancers	Quntariyya Al-Ibil Al-Himyar	true
land_units_onscreen_name_att_des_es_armoured_himyarite_shotelai	Ibil Al-Himyar	true
land_units_onscreen_name_att_des_es_ashum	Rumat Al-Yaman	true
land_units_onscreen_name_att_des_es_athars_chosen	Ghazawat	true
land_units_onscreen_name_att_des_es_badyia_skirmishers	Mazariq Al-Arab	true
land_units_onscreen_name_att_des_es_baltha_defenders	Tabardariyya Al-Khamis	true
land_units_onscreen_name_att_des_es_baltha_warriors	Tabardariyya Al-Qayl	true
land_units_onscreen_name_att_des_es_behers_chosen	Sab'a 'Asyaf za-Beher	true
land_units_onscreen_name_att_des_es_bet_giorgis_cavalry	Sab'a Afras za-Hawari	true
land_units_onscreen_name_att_des_es_desert_pikes	Rammah Al-Sham	true
land_units_onscreen_name_att_des_es_dune_lancers	Quntariyya Al-Badawi	true
land_units_onscreen_name_att_des_es_elite_tor_warriors	Sab'a 'Armah za-Habasa	true
land_units_onscreen_name_att_des_es_himyarite_shotelai	Fawaris Al-Himyar	true
land_units_onscreen_name_att_des_es_jamal_al_baltha	Rammah Al-Ibil Al-Baltha	true
land_units_onscreen_name_att_des_es_jamal_al_rumha	Rumat Al-Ibil Al-Bedawi	true
land_units_onscreen_name_att_des_es_khahyahlim	Rammah Al-Khamis	true
land_units_onscreen_name_att_des_es_marz_archers	Darabawiat za-Haqqalat	true
land_units_onscreen_name_att_des_es_masqal_spearmen	Sab'a 'Armah za-Hawari	true
land_units_onscreen_name_att_des_es_mavias_bodyguards	Quntariyya Al-Mujaffat	true
land_units_onscreen_name_att_des_es_mavias_chargers	Quntariyya Al-Jund	true
land_units_onscreen_name_att_des_es_mavias_chosen	Quntariyya Al-Mujaffat	true
land_units_onscreen_name_att_des_es_mavias_lancers	Quntariyya Al-Tanukh	true
land_units_onscreen_name_att_des_es_mounted_marz_archers	Sab'a Gamalat za-Haqqalat	true
land_units_onscreen_name_att_des_es_ras_guard	Aqqabi Re's	true
land_units_onscreen_name_att_des_es_rebellion_militia	Ghawgha	true
land_units_onscreen_name_att_des_es_rumha_skirmishers	Mazariq Al-Yaman	true
land_units_onscreen_name_att_des_es_rumha_warriors	Mazariq Al-Habash	true
land_units_onscreen_name_att_des_es_sahnegohrim	Asyaf Al-Khamis	true
land_units_onscreen_name_att_des_es_kings_radif	Fawaris Al-Radif Al-Malik	true
land_units_onscreen_name_att_des_es_noble_al_rahrain	Asyaf Al-Raha'in	true
land_units_onscreen_name_att_des_es_sanai	Fawaris Al-Mahla	true
land_units_onscreen_name_att_des_es_sons_of_the_invincible_mahrem	Saba 'Armah za-Negusawi	true
land_units_onscreen_name_att_des_es_spice_guard	Spice Guard	true
land_units_onscreen_name_att_des_es_spice_warriors	Spice Warriors	true
land_units_onscreen_name_att_des_es_tanukhid_ambushers	Asyaf Al-Badawi	true
land_units_onscreen_name_att_des_es_tanukhid_pikes	Rammah Al-Jund Al-Sham	true
land_units_onscreen_name_att_des_es_tor_warriors	Sab'a 'Armah za-Haqqalat	true
land_units_onscreen_name_att_des_es_wadai	Quntariyya Al-Hamra	true
land_units_onscreen_name_att_des_es_zafar_sentinels	Tabardariyya Al-Khass Al-Himyar	true
land_units_onscreen_name_att_des_es_zealot_sicarius	Kana'im	true
land_units_onscreen_name_att_des_es_zodiac_archers	Fawaris Al-Hamra'	true
land_units_onscreen_name_att_des_garamantian_hunters	Sigittarii Mauri Clipeati	true
land_units_onscreen_name_att_des_garamantian_lancers	Equites Lanciarii Berberorum	true
land_units_onscreen_name_att_des_kushite_mounted_shotelai	Sab'a Afras za-Kasu	true
land_units_onscreen_name_att_des_kushite_shotelai	Sab'a 'Asyaf za-Negusawi 	true
land_units_onscreen_name_att_des_noble_arab_camelry	Rammah Ahl al-Sham	true
land_units_onscreen_name_att_des_noble_numidian_cavalry	Equites Comitati Maurorum	true
land_units_onscreen_name_att_des_onager	Onager	true
land_units_onscreen_name_att_des_onager_bastion	Bastion Onager	true
land_units_onscreen_name_att_des_shawia_guard	Lanciarii Africanorum	true
land_units_onscreen_name_att_des_tuareg_camel_spearmen	Dromedarii Africani	true
land_units_onscreen_name_fote_arab_cataphracts_shielded	Quntariyya Al-Musfaha	true
land_units_onscreen_name_fote_arab_spearmen_t3_unarmored	Rammah Al-Jund	true
land_units_onscreen_name_fote_arab_spearmen_t4_armored	Rammah Al-Murtaziqa	true
land_units_onscreen_name_fote_axum_cavalry_melee_t1	Sab'a Afras za-Habasa	true
land_units_onscreen_name_fote_axum_club_levies	Sab'a Abara Sata	true
land_units_onscreen_name_fote_axum_elephant_bodyguard	Haramez-a Negusawi	true
land_units_onscreen_name_fote_axum_elephant_no_tower	Haramez-a Haqqalat	true
land_units_onscreen_name_fote_axum_elephant_tower	Haramez-a Habasa	true
land_units_onscreen_name_fote_axum_javelinmen_t1_tribal	Sab'a Mezraqat za-Haqqalat	true
land_units_onscreen_name_fote_axum_javelinmen_t2_abyssinian	Sab'a Mezraqat za-Habasa	true
land_units_onscreen_name_fote_axum_slinger_standard	Wenichâ€™afiwochi za-Haqqalat	true
land_units_onscreen_name_fote_berber_archer_t1	Sagittarii Mauri	true
land_units_onscreen_name_fote_berber_archer_t2	Kastem Inumiden	true
land_units_onscreen_name_fote_berber_cavalry_melee_t3_romanized	Equites Romano-Maurorum	true
land_units_onscreen_name_fote_berber_javelinmen_t1	Levis Armaturae Numidarum	true
land_units_onscreen_name_fote_berber_javelinmen_t2	Ferentarii Mauri	true
land_units_onscreen_name_fote_berber_slingers_t1	Funditores Mauri	true
land_units_onscreen_name_fote_berber_spearmen_t3_nobles	Aanatim Inumiden	true
land_units_onscreen_name_fote_berber_spearmen_t3_romanized	Lanciarii Romano-Maurorum	true
land_units_onscreen_name_fote_berber_swordsmen_t1	Spatharii Mauri	true
land_units_onscreen_name_fote_berber_swordsmen_t2_light	Mashliyim Inumiden	true
land_units_onscreen_name_fote_berber_swordsmen_t2_romanized	Spatharii Romano-Maurorum	true
