key	text	tooltip
#Loc;1;text/db/fote_aoc_land_units.loc		
land_units_onscreen_name_cha_avar_boatmen	Avar Boatmen	true
land_units_onscreen_name_cha_avar_foot_archers	Avar Foot Archers	true
land_units_onscreen_name_cha_avar_guard	Avar Guard	true
land_units_onscreen_name_cha_avar_guard_boatmen	Avar Guard Boatmen	true
land_units_onscreen_name_cha_avar_heavy_boatmen	Avar Heavy Boatmen	true
land_units_onscreen_name_cha_avar_horse_archers	Avar Horse Archers	true
land_units_onscreen_name_cha_avar_horse_masters	Avar Horse Masters	true
land_units_onscreen_name_cha_avar_lancers	Avar Lancers	true
land_units_onscreen_name_cha_avar_levy_archers	Levy Archers	true
land_units_onscreen_name_cha_avar_levy_spear	Levy Spearmen	true
land_units_onscreen_name_cha_avar_light_boatmen	Avar Light Boatmen	true
land_units_onscreen_name_cha_avar_noble_archers	Avar Noble Horse Archers	true
land_units_onscreen_name_cha_avar_noble_lancers	Avar Noble Lancers	true
land_units_onscreen_name_cha_avar_noble_sword	Avar Noble Swordsmen	true
land_units_onscreen_name_cha_avar_onager	Onager	true
land_units_onscreen_name_cha_avar_onager_bastion	Bastion Onager	true
land_units_onscreen_name_cha_avar_shieldbearers	Spearmen Sparaba	true
land_units_onscreen_name_cha_avar_spear	Spearmen	true
land_units_onscreen_name_cha_avar_tribesmen	Tribesmen	true
land_units_onscreen_name_cha_bre_armorican_cav	Armorican Cavalry	true
land_units_onscreen_name_cha_bre_armorican_knights	Armorican Knights	true
land_units_onscreen_name_cha_byz_archer_boatmen	Archer Boatmen	true
land_units_onscreen_name_cha_byz_archers	Toxotai (Archers)	true
land_units_onscreen_name_cha_byz_armoured_archers	Toxotai Thorakites (Armored Bowmen)	true
land_units_onscreen_name_cha_byz_artillery_crew	Balistaroi	true
land_units_onscreen_name_cha_byz_duxs_guard	Optimatos	true
land_units_onscreen_name_cha_byz_elite_skutatoi_spear	Epilektoi Hoplitai (Heavy Spearmen)	true
land_units_onscreen_name_cha_byz_guard_marines	Guard Marines	true
land_units_onscreen_name_cha_byz_horse_archer_kursores	Kursores (Horse Archers)	true
land_units_onscreen_name_cha_byz_iuvenes	Spatharioi Iuvenes (Light Swordsmen)	true
land_units_onscreen_name_cha_byz_large_onager	Large Onager	true
land_units_onscreen_name_cha_byz_levy_marines	Levy Marines	true
land_units_onscreen_name_cha_byz_levy_spear	Doryphoroi (Levy Spearmen)	true
land_units_onscreen_name_cha_byz_light_cav	Kavallarioi (Light Cavalry)	true
land_units_onscreen_name_cha_byz_medium_cav_defensores	Defensores (Line Cavalry)	true
land_units_onscreen_name_cha_byz_onager	Onager	true
land_units_onscreen_name_cha_byz_onager_bastion	Bastion Onager	true
land_units_onscreen_name_cha_byz_scout_cavalry	Procursatores (Scout Cavalry)	true
land_units_onscreen_name_cha_byz_skirm	Akontistai (Javelinmen)	true
land_units_onscreen_name_cha_byz_skutatoi	Spatharioi Hoplitai (Skutatoi Swordsmen)	true
land_units_onscreen_name_cha_byz_skutatoi_axemen	Pelekyphoroi Hoplitai (Skutatoi Axemen)	true
land_units_onscreen_name_cha_byz_skutatoi_marines	Skutatoi Marines	true
land_units_onscreen_name_cha_byz_skutatoi_pyro	Spatharioi ton Hygròn Pŷr (Skutatoi with Bombs)	true
land_units_onscreen_name_cha_byz_skutatoi_spear	Skutatoi (Skutatoi Spearmen)	true
land_units_onscreen_name_cha_byz_tagmata_cavalry	Tagmata Kavallarioi	true
land_units_onscreen_name_cha_cel_archer_boatmen	Archer Boatmen	true
land_units_onscreen_name_cha_cel_armoured_spear	Armoured Spearmen	true
land_units_onscreen_name_cha_cel_armoured_spear_pictish	Pictish Armoured Spearmen	true
land_units_onscreen_name_cha_cel_axemen	Axemen	true
land_units_onscreen_name_cha_cel_fianna	Fianna	true
land_units_onscreen_name_cha_cel_gazelhounds	Gazehounds	true
land_units_onscreen_name_cha_cel_horsemen	Horsemen	true
land_units_onscreen_name_cha_cel_javelin_boatmen	Javelin Boatmen	true
land_units_onscreen_name_cha_cel_javelinmen	Javelinmen	true
land_units_onscreen_name_cha_cel_kerns	Kerns	true
land_units_onscreen_name_cha_cel_kings_fianna	King's Fianna	true
land_units_onscreen_name_cha_cel_kings_warband	King's Warband	true
land_units_onscreen_name_cha_cel_levy_archers	Levy Archers	true
land_units_onscreen_name_cha_cel_levy_spear	Levy Spearmen	true
land_units_onscreen_name_cha_cel_light_cavalry	Celtic Light Horsemen	true
land_units_onscreen_name_cha_cel_onager	Onager	true
land_units_onscreen_name_cha_cel_onager_bastion	Bastion Onager	true
land_units_onscreen_name_cha_cel_pictish_archers	Pictish Archers	true
land_units_onscreen_name_cha_cel_pictish_crossbowmen	Pictish Crossbowmen	true
land_units_onscreen_name_cha_cel_pictish_nobles	Pictish Nobles	true
land_units_onscreen_name_cha_cel_royal_horsemen	Royal Horsemen	true
land_units_onscreen_name_cha_cel_spear	Spearmen	true
land_units_onscreen_name_cha_cel_spear_boatmen	Spear Boatmen	true
land_units_onscreen_name_cha_cel_sword	Swordsmen	true
land_units_onscreen_name_cha_cel_sword_band	Sword Band	true
land_units_onscreen_name_cha_cel_sword_boatmen	Sword Boatmen	true
land_units_onscreen_name_cha_cel_sword_warriors	Sword Warriors	true
land_units_onscreen_name_cha_cel_teulu	Teulu	true
land_units_onscreen_name_cha_cel_teulu_marines	Teulu Marines	true
land_units_onscreen_name_cha_cel_welsh_archers	Welsh Archers	true
land_units_onscreen_name_cha_cel_welsh_longbowmen	Welsh Longbowmen	true
land_units_onscreen_name_cha_eng_crossbowmen	Crossbowmen	true
land_units_onscreen_name_cha_eng_fyrd_archer_boatmen	Fyrd Archer Boatmen	true
land_units_onscreen_name_cha_eng_fyrd_archers	Fyrd Archers	true
land_units_onscreen_name_cha_eng_fyrd_axemen	Fyrd Axemen	true
land_units_onscreen_name_cha_eng_fyrd_boatmen	Fyrd Boatmen	true
land_units_onscreen_name_cha_eng_fyrd_javelinmen	Fyrd Javelinmen	true
land_units_onscreen_name_cha_eng_fyrd_slingers	Fyrd Slingers	true
land_units_onscreen_name_cha_eng_fyrd_spear	Fyrd Spearmen	true
land_units_onscreen_name_cha_eng_fyrd_sword	Fyrd Swordsmen	true
land_units_onscreen_name_cha_eng_horsemen	Horsemen	true
land_units_onscreen_name_cha_eng_onager	Onager	true
land_units_onscreen_name_cha_eng_onager_bastion	Bastion Onager	true
land_units_onscreen_name_cha_eng_royal_companions	Royal Companions	true
land_units_onscreen_name_cha_eng_royal_companions_mounted	Mounted Royal Guard	true
land_units_onscreen_name_cha_eng_royal_horsemen	Royal Horsemen	true
land_units_onscreen_name_cha_eng_royal_marines	Royal Marines	true
land_units_onscreen_name_cha_eng_royal_thegns	Royal Thegns	true
land_units_onscreen_name_cha_eng_select_archers	Select Archers	true
land_units_onscreen_name_cha_eng_select_axemen	Select Axemen	true
land_units_onscreen_name_cha_eng_select_spear	Select Spearmen	true
land_units_onscreen_name_cha_eng_thegn_boatmen	Thegn Boatmen	true
land_units_onscreen_name_cha_eng_thegn_spearmen	Thegn Spearmen	true
land_units_onscreen_name_cha_eng_thegns	Thegns	true
land_units_onscreen_name_cha_fra_archers	Sagittarii Exercitum (Army Archers)	true
land_units_onscreen_name_cha_fra_armoured_spear	Lanciarii Exercitum (Heavy Spearmen)	true
land_units_onscreen_name_cha_fra_armoured_sword	Spatharii Exercitum (Heavy Swordsmen)	true
land_units_onscreen_name_cha_fra_artillery_crew	Frankish Artillery Crew	true
land_units_onscreen_name_cha_fra_cav	Caballari Exercitum (Army Horsemen)	true
land_units_onscreen_name_cha_fra_crossbowmen	Arcubalistarii	true
land_units_onscreen_name_cha_fra_guardsmen	Milites Aulae Regiae (Knights of the Court)	true
land_units_onscreen_name_cha_fra_heavy_marines	Frankish Heavy Marines	true
land_units_onscreen_name_cha_fra_horse_archers	Equites Sagittarii (Horse Archers)	true
land_units_onscreen_name_cha_fra_horsemen	Bannum Caballariorum (Freemen Horsemen)	true
land_units_onscreen_name_cha_fra_horsemen_landowners	Vassi Caballariorum (Nobles' Horsemen)	true
land_units_onscreen_name_cha_fra_large_onager	Large Onager	true
land_units_onscreen_name_cha_fra_levy_archers	Sagittarii Landweri (Levy Archers)	true
land_units_onscreen_name_cha_fra_levy_skirm	Cives Armati (Levy Skirmishers)	true
land_units_onscreen_name_cha_fra_levy_spear	Pedites Landweri (Levy Spearmen)	true
land_units_onscreen_name_cha_fra_light_boatmen	Light Boatmen	true
land_units_onscreen_name_cha_fra_marines	Frankish Marines	true
land_units_onscreen_name_cha_fra_mounted_archers	Equitatus Sagittarii Exercitum (Mounted Archers)	true
land_units_onscreen_name_cha_fra_mounted_spear	Milites Lanciarii Exercitum (Mounted Infantry Spearmen)	true
land_units_onscreen_name_cha_fra_mounted_swordsmen	Milites Spatharii Exercitum (Mounted Infantry Swordsmen)	true
land_units_onscreen_name_cha_fra_onager	Onager	true
land_units_onscreen_name_cha_fra_onager_bastion	Bastion Onager	true
land_units_onscreen_name_cha_fra_palace_guard	Milites Palatini (Royal Spearmen)	true
land_units_onscreen_name_cha_fra_paladin_guardsmen	Equites Loricati Palatini (Royal Knights)	true
land_units_onscreen_name_cha_fra_picked_marines	Picked Marines	true
land_units_onscreen_name_cha_fra_scola_cav	Caballarii Scholae (Heavy Horsemen)	true
land_units_onscreen_name_cha_fra_scola_knights	Milites Scholae (Knights)	true
land_units_onscreen_name_cha_fra_skirm	Ferentarii (Javelinmen)	true
land_units_onscreen_name_cha_fra_spear	Bannum Lanciariorum (Freemen Spearmen)	true
land_units_onscreen_name_cha_fra_sword	Bannum Spatharorum (Freemen Swordsmen)	true
land_units_onscreen_name_cha_gen_archers	Sagittarii (Archers)	true
land_units_onscreen_name_cha_gen_armoured_spear	Lanciarii Armaturae (Armored Spearmen)	true
land_units_onscreen_name_cha_gen_armoured_sword	Spatharii Armaturae (Armored Swordsmen)	true
land_units_onscreen_name_cha_gen_artillery_crew	Balistarii	true
land_units_onscreen_name_cha_gen_crossbowmen	Arcubalistarii	true
land_units_onscreen_name_cha_gen_crossbowmen_levy	Arcubalistarii	true
land_units_onscreen_name_cha_gen_guard_cav	Milites Loricati	true
land_units_onscreen_name_cha_gen_guard_marines	Guard Marines	true
land_units_onscreen_name_cha_gen_heavy_marines	Heavy Marines	true
land_units_onscreen_name_cha_gen_horsemen_landowners	Caballarii Optimati (Nobles' Cavalry)	true
land_units_onscreen_name_cha_gen_knights	Milites (Knights)	true
land_units_onscreen_name_cha_gen_large_onager	Large Onager	true
land_units_onscreen_name_cha_gen_levy_archers	Pagi Sagittarii (Peasant Archers)	true
land_units_onscreen_name_cha_gen_levy_skirm	Levis Armaturae (Levy Skirmishers)	true
land_units_onscreen_name_cha_gen_levy_spear	Pagi Lanciarii (Peasant Spearmen)	true
land_units_onscreen_name_cha_gen_light_boatmen	Light Boatmen	true
land_units_onscreen_name_cha_gen_marines	Marines	true
land_units_onscreen_name_cha_gen_noble_cav	Caballarii Comitatorum (Nobles' Horsemen)	true
land_units_onscreen_name_cha_gen_onager	Onager	true
land_units_onscreen_name_cha_gen_onager_bastion	Bastion Onager	true
land_units_onscreen_name_cha_gen_skirm	Ferentarii (Javelinmen)	true
land_units_onscreen_name_cha_gen_skirm_cav	Equites Ferentarii (Light Cavalry)	true
land_units_onscreen_name_cha_gen_spear	Lanciarii (Spearmen)	true
land_units_onscreen_name_cha_gen_sword	Spatharii (Swordsmen)	true
land_units_onscreen_name_cha_lom_archers	Sagittarii Arimanni (Freeborn Archers)	true
land_units_onscreen_name_cha_lom_artillery_crew	Balistarii	true
land_units_onscreen_name_cha_lom_axemen	Pedites Arimanni (Freeborn Axemen)	true
land_units_onscreen_name_cha_lom_clubmen	Cives Armaturae (Armed Citizens)	true
land_units_onscreen_name_cha_lom_gastald_cav	Equites Gastaldii (Noble Horsemen)	true
land_units_onscreen_name_cha_lom_gastald_guardsmen	Equites Regum (Royal Horsemen)	true
land_units_onscreen_name_cha_lom_gastald_knights	Equites Gasindii (High Nobles' Cavalry)	true
land_units_onscreen_name_cha_lom_gastald_marines	Gastald Marines	true
land_units_onscreen_name_cha_lom_gastald_swordsmen	Spatharii Gastaldii (Noble Swordsmen)	true
land_units_onscreen_name_cha_lom_guardsmen	Lanciarii Gastaldii (Noble Spearmen)	true
land_units_onscreen_name_cha_lom_heavy_marines	Lombard Heavy Marines	true
land_units_onscreen_name_cha_lom_horsemen	Equites Langobardii (Lombard Horsemen)	true
land_units_onscreen_name_cha_lom_horsemen_landowners	Equites Gastaldii (Noble Mounted Spearmen)	true
land_units_onscreen_name_cha_lom_lancers	Contarii Langobardorum (Lombard Lancers)	true
land_units_onscreen_name_cha_lom_large_onager	Large Onager	true
land_units_onscreen_name_cha_lom_levy	Pagi Armaturae (Armed Peasants)	true
land_units_onscreen_name_cha_lom_levy_archers	Pagi Sagittarii (Peasant Archers)	true
land_units_onscreen_name_cha_lom_levy_axemen	Pedites Servorum (Armed Servants)	true
land_units_onscreen_name_cha_lom_levy_skirm	Levis Armaturae (Levy Skirmishers)	true
land_units_onscreen_name_cha_lom_levy_spear	Servi Lanciarii (Serf Spearmen)	true
land_units_onscreen_name_cha_lom_light_boatmen	Lombard Light Boatmen	true
land_units_onscreen_name_cha_lom_marines	Lombard Marines	true
land_units_onscreen_name_cha_lom_night_raiders	Equites Avarorum (Avar Horse Skirmishers)	true
land_units_onscreen_name_cha_lom_onager	Onager	true
land_units_onscreen_name_cha_lom_onager_bastion	Bastion Onager	true
land_units_onscreen_name_cha_lom_raider_cav	Equites Ferentarii (Light Cavalry Skirmishers)	true
land_units_onscreen_name_cha_lom_skirm	Ferentarii (Javelinmen)	true
land_units_onscreen_name_cha_lom_spear	Lanciarii Arimanni (Freeborn Spearmen)	true
land_units_onscreen_name_cha_lom_sword	Spatharii Arimanni (Freeborn Swordsmen)	true
land_units_onscreen_name_cha_merc_avar_boatmen	Mercenary Avar Boatmen	true
land_units_onscreen_name_cha_merc_avar_horse_archers	Mercenary Avar Horse Archers	true
land_units_onscreen_name_cha_merc_avar_lancers	Mercenary Avar Lancers	true
land_units_onscreen_name_cha_merc_avar_light_boatmen	Mercenary Avar Light Boatmen	true
land_units_onscreen_name_cha_merc_bre_armorican_cav	Mercenary Armorican Cavalry	true
land_units_onscreen_name_cha_merc_byz_archer_boatmen	Mercenary Byzantine Archer Boatmen	true
land_units_onscreen_name_cha_merc_byz_archers	Mercenary Byzantine Archers	true
land_units_onscreen_name_cha_merc_byz_levy_marines	Mercenary Byzantine Marines	true
land_units_onscreen_name_cha_merc_byz_light_cav	Mercenary Byzantine Cavalry	true
land_units_onscreen_name_cha_merc_byz_skutatoi	Mercenary Skutatoi	true
land_units_onscreen_name_cha_merc_byz_skutatoi_marines	Mercenary Skutatoi Marines	true
land_units_onscreen_name_cha_merc_cel_archer_boatmen	Mercenary Celtic Archer Boatmen	true
land_units_onscreen_name_cha_merc_cel_armoured_spear	Mercenary Welsh Armoured Spearmen	true
land_units_onscreen_name_cha_merc_cel_fianna	Mercenary Fianna	true
land_units_onscreen_name_cha_merc_cel_horsemen	Mercenary Celtic Horsemen	true
land_units_onscreen_name_cha_merc_cel_javelin_boatmen	Mercenary Irish Javelin Boatmen	true
land_units_onscreen_name_cha_merc_cel_kerns	Mercenary Kerns	true
land_units_onscreen_name_cha_merc_cel_pictish_crossbowmen	Mercenary Pictish Crossbowmen	true
land_units_onscreen_name_cha_merc_cel_spear_boatmen	Mercenary Celtic Spear Boatmen	true
land_units_onscreen_name_cha_merc_cel_sword_band	Mercenary Pitcish Sword Band	true
land_units_onscreen_name_cha_merc_cel_welsh_archers	Mercenary Welsh Archers	true
land_units_onscreen_name_cha_merc_eng_fyrd_archer_boatmen	Mercenary Fyrd Archer Boatmen	true
land_units_onscreen_name_cha_merc_eng_fyrd_archers	Mercenary Fyrd Archers	true
land_units_onscreen_name_cha_merc_eng_fyrd_boatmen	Mercenary Fyrd Boatmen	true
land_units_onscreen_name_cha_merc_eng_fyrd_spear	Mercenary Fyrd Spearmen	true
land_units_onscreen_name_cha_merc_eng_horsemen	Mercenary English Horsemen	true
land_units_onscreen_name_cha_merc_eng_thegns	Mercenary Thegns	true
land_units_onscreen_name_cha_merc_fra_archers	Mercenary Frankish Archers	true
land_units_onscreen_name_cha_merc_fra_armoured_sword	Mercenary Frankish Armoured Swordsmen	true
land_units_onscreen_name_cha_merc_fra_horsemen	Mercenary Frankish Horsemen	true
land_units_onscreen_name_cha_merc_fra_light_boatmen	Mercenary Frankish Light Boatmen	true
land_units_onscreen_name_cha_merc_fra_marines	Mercenary Frankish Marines	true
land_units_onscreen_name_cha_merc_fra_spear	Mercenary Frankish Spearmen	true
land_units_onscreen_name_cha_merc_gen_archers	Mercenary Archers	true
land_units_onscreen_name_cha_merc_gen_armoured_spear	Mercenary Armoured Spearmen	true
land_units_onscreen_name_cha_merc_gen_armoured_sword	Mercenary Armoured Swordsmen	true
land_units_onscreen_name_cha_merc_gen_light_boatmen	Mercenary Light Boatmen	true
land_units_onscreen_name_cha_merc_gen_marines	Mercenary Marines	true
land_units_onscreen_name_cha_merc_gen_skirm	Mercenary Skirmishers	true
land_units_onscreen_name_cha_merc_gen_skirm_cav	Mercenary Skirmisher Cavalry	true
land_units_onscreen_name_cha_merc_gen_spear	Mercenary Spearmen	true
land_units_onscreen_name_cha_merc_lom_archers	Mercenary Lombard Archers	true
land_units_onscreen_name_cha_merc_lom_clubmen	Mercenary Lombard Clubmen	true
land_units_onscreen_name_cha_merc_lom_horsemen	Mercenary Lombard Horsemen	true
land_units_onscreen_name_cha_merc_lom_light_boatmen	Mercenary Lombard Light Boatmen	true
land_units_onscreen_name_cha_merc_lom_marines	Mercenary Lombard Marines	true
land_units_onscreen_name_cha_merc_lom_raider_cav	Mercenary Lombard Raider Cavalry	true
land_units_onscreen_name_cha_merc_lom_spear	Mercenary Lombard Spearmen	true
land_units_onscreen_name_cha_merc_mus_andalusian_archer_boatmen	Mercenary Andalusian Archer Boatmen	true
land_units_onscreen_name_cha_merc_mus_andalusian_cav	Mercenary Fawaris Al-Hasham (Foreign Heavy Cavalry)	true
land_units_onscreen_name_cha_merc_mus_andalusian_infantry	Mercenary Andalusian Infantry	true
land_units_onscreen_name_cha_merc_mus_andalusian_marines	Mercenary Andalusian Marines	true
land_units_onscreen_name_cha_merc_mus_andalusian_skirm	Mercenary Andalusian Skirmishers	true
land_units_onscreen_name_cha_merc_mus_berber_levy	Rammah Al-Sudan (African Spearmen)	true
land_units_onscreen_name_cha_merc_mus_berber_raiders	Fawaris Al-Barbar (Berber Horsemen)	true
land_units_onscreen_name_cha_merc_mus_berber_spearmen	Rammah Abid Al-Shira (African Slave-Warriors)	true
land_units_onscreen_name_cha_merc_sax_boatmen	Mercenary Saxon Boatmen	true
land_units_onscreen_name_cha_merc_sax_javelinmen	Mercenary Saxon Javelinmen	true
land_units_onscreen_name_cha_merc_sax_light_raiders	Mercenary Saxon Light Raiders	true
land_units_onscreen_name_cha_merc_sax_raiders	Mercenary Saxon Raiders	true
land_units_onscreen_name_cha_merc_sax_scout_cav	Mercenary Scout Cavalry	true
land_units_onscreen_name_cha_merc_sax_seax_warriors	Mercenary Seax Warriors	true
land_units_onscreen_name_cha_merc_sax_spear_band	Mercenary Saxon Spear Band	true
land_units_onscreen_name_cha_merc_slav_ambushers	Mercenary Slavic Ambushers	true
land_units_onscreen_name_cha_merc_slav_archers	Mercenary Slavic Archers	true
land_units_onscreen_name_cha_merc_slav_boatmen	Mercenary Slav Boatmen	true
land_units_onscreen_name_cha_merc_slav_light_boatmen	Mercenary Slav Light Boatmen	true
land_units_onscreen_name_cha_merc_slav_raiders	Mercenary Slav Raiders	true
land_units_onscreen_name_cha_merc_slav_tribesmen	Mercenary Slav Tribesmen	true
land_units_onscreen_name_cha_merc_spa_ambushers	Mercenary Spanish Ambushers	true
land_units_onscreen_name_cha_merc_spa_iberian_cav	Mercenary Iberian Cavalry	true
land_units_onscreen_name_cha_merc_spa_raider_cav	Mercenary Spanish Raider Cavalry	true
land_units_onscreen_name_cha_merc_vik_archers	Mercenary Viking Archers	true
land_units_onscreen_name_cha_merc_vik_axe_freemen	Mercenary Axe Freemen	true
land_units_onscreen_name_cha_merc_vik_big_axes	Mercenary Big Axes	true
land_units_onscreen_name_cha_merc_vik_raiders	Mercenary Viking Raiders	true
land_units_onscreen_name_cha_merc_vik_ship_archers	Mercenary Viking Ship Archers	true
land_units_onscreen_name_cha_merc_vik_smashers	Mercenary Viking Smashers	true
land_units_onscreen_name_cha_merc_vik_sword_hirdmen	Mercenary Sword Hirdmen	true
land_units_onscreen_name_cha_mus_andalusian_archer_boatmen	Andalusian Archer Boatmen	true
land_units_onscreen_name_cha_mus_andalusian_archer_marines	Andalusian Archer Marines	true
land_units_onscreen_name_cha_mus_andalusian_cav	Fawaris Al-Hasham (Heavy Cavalry)	true
land_units_onscreen_name_cha_mus_andalusian_guard_marines	Andalusian Guard Marines	true
land_units_onscreen_name_cha_mus_andalusian_infantry	Asyaf Al-Muttawi'a (Volunteer Swordsmen)	true
land_units_onscreen_name_cha_mus_andalusian_marines	Andalusian Marines	true
land_units_onscreen_name_cha_mus_andalusian_skirm	Mazariq Al-Barbar (Berber Javelinmen)	true
land_units_onscreen_name_cha_mus_andalusian_warriors	Asyaf Al-Jund (Army Swordsmen)	true
land_units_onscreen_name_cha_mus_archers	Rumat Al-Andalus (Andalusian Archers)	true
land_units_onscreen_name_cha_mus_armoured_archers	Rumat Al-Jund (Army Bowmen)	true
land_units_onscreen_name_cha_mus_armoured_cav	Fawaris Al-Khurs (Christian Guard Horsemen)	true
land_units_onscreen_name_cha_mus_armoured_marines	Armoured Marines	true
land_units_onscreen_name_cha_mus_artillery_crew	Andalusian Artillery Crew	true
land_units_onscreen_name_cha_mus_berber_horsemen	Fawaris Al-Jund (Army Horsemen)	true
land_units_onscreen_name_cha_mus_berber_jinetes	Fawaris Al-Ashraf Al-Barbar (Berber Nobles)	true
land_units_onscreen_name_cha_mus_berber_levy	Rammah Al-Muttawi'a (Volunteer Spearmen)	true
land_units_onscreen_name_cha_mus_berber_light_cav	Fawaris Al-Muttawi'a (Volunteer Horsemen)	true
land_units_onscreen_name_cha_mus_berber_raiders	Fawaris Al-Barbar (Berber Tribal Horsemen)	true
land_units_onscreen_name_cha_mus_berber_spearmen	Rammah Al-Andalus (Andalusian Spearmen)	true
land_units_onscreen_name_cha_mus_berber_warriors	Rammah Al-Jund (Army Spearmen)	true
land_units_onscreen_name_cha_mus_black_guard_spearmen	Irafat Al-Sudan (Black Guard)	true
land_units_onscreen_name_cha_mus_large_onager	Large Onager	true
land_units_onscreen_name_cha_mus_onager	Onager	true
land_units_onscreen_name_cha_mus_onager_bastion	Bastion Onager	true
land_units_onscreen_name_cha_mus_slingers	Maqali Al-Andalus (Andalusian Slingers)	true
land_units_onscreen_name_cha_mus_umayyad_guard_cav	Fawaris Al-Haras (Guard Horsemen)	true
land_units_onscreen_name_cha_mus_umayyad_guardsmen	Rammah Al-Khurs (Christian Guard Spearmen)	true
land_units_onscreen_name_cha_pap_guardsmen	Papal Guardsmen	true
land_units_onscreen_name_cha_pope	The Pope	true
land_units_onscreen_name_cha_sax_archers	Archers	true
land_units_onscreen_name_cha_sax_axe_band	Axe Band	true
land_units_onscreen_name_cha_sax_axe_warriors	Axe Warriors	true
land_units_onscreen_name_cha_sax_boatmen	Saxon Boatmen	true
land_units_onscreen_name_cha_sax_cav	Saxon Cavalry	true
land_units_onscreen_name_cha_sax_guard_cav	Saxon Cavalry Guard	true
land_units_onscreen_name_cha_sax_hearth_cav	Mounted Hearth Guard	true
land_units_onscreen_name_cha_sax_hearth_guard	Hearth Guard	true
land_units_onscreen_name_cha_sax_hearth_infantry	Hearth Infantry	true
land_units_onscreen_name_cha_sax_hearth_marines	Hearth Marines	true
land_units_onscreen_name_cha_sax_heavy_boatmen	Saxon Heavy Boatmen	true
land_units_onscreen_name_cha_sax_javelinmen	Javelinmen	true
land_units_onscreen_name_cha_sax_levy_archers	Levy Archers	true
land_units_onscreen_name_cha_sax_levy_javelinmen	Levy Javelinmen	true
land_units_onscreen_name_cha_sax_light_raiders	Saxon Light Raiders	true
land_units_onscreen_name_cha_sax_noble_javelinmen	Noble Javelinmen	true
land_units_onscreen_name_cha_sax_onager	Onager	true
land_units_onscreen_name_cha_sax_onager_bastion	Bastion Onager	true
land_units_onscreen_name_cha_sax_raiders	Saxon Raiders	true
land_units_onscreen_name_cha_sax_scout_cav	Scout Cavalry	true
land_units_onscreen_name_cha_sax_seax_band	Seax Band	true
land_units_onscreen_name_cha_sax_seax_warriors	Seax Warriors	true
land_units_onscreen_name_cha_sax_spear_band	Spear Band	true
land_units_onscreen_name_cha_sax_spear_veterans	Spear Veterans	true
land_units_onscreen_name_cha_sax_spear_warriors	Spear Warriors	true
land_units_onscreen_name_cha_sax_sword_veterans	Sword Veterans	true
land_units_onscreen_name_cha_sax_warhounds	Warhounds	true
land_units_onscreen_name_cha_slav_ambushers	Ambushers	true
land_units_onscreen_name_cha_slav_archers	Archers	true
land_units_onscreen_name_cha_slav_boatmen	Slav Boatmen	true
land_units_onscreen_name_cha_slav_champions	Slav Champions	true
land_units_onscreen_name_cha_slav_elite_boatmen	Slav Elite Boatmen	true
land_units_onscreen_name_cha_slav_large_shields	Large Shields	true
land_units_onscreen_name_cha_slav_light_boatmen	Slav Light Boatmen	true
land_units_onscreen_name_cha_slav_onager	Onager	true
land_units_onscreen_name_cha_slav_onager_bastion	Bastion Onager	true
land_units_onscreen_name_cha_slav_raiders	Slav Raiders	true
land_units_onscreen_name_cha_slav_royal_cav	Slav Royal Cavalry	true
land_units_onscreen_name_cha_slav_slashers	Slav Slashers	true
land_units_onscreen_name_cha_slav_skirm	Skirmishers	true
land_units_onscreen_name_cha_slav_spear	Spearmen	true
land_units_onscreen_name_cha_slav_tribesmen	Slav Tribesmen	true
land_units_onscreen_name_cha_slav_warriors	Slav Warriors	true
land_units_onscreen_name_cha_spa_ambushers	Bellatores Asturorum (Asturian Warriors)	true
land_units_onscreen_name_cha_spa_iberian_cav	Caballeros Villanos (Horsemen of the Commons)	true
land_units_onscreen_name_cha_spa_jinetes	Caballeros Jinetes (Jinetes Horsemen)	true
land_units_onscreen_name_cha_spa_noble_skirm	Ferentarii Vasconorum (Gasco-Basque Skirmishers)	true
land_units_onscreen_name_cha_spa_raider_cav	Caballeros Vascos (Gasco-Basque Horsemen)	true
land_units_onscreen_name_cha_spa_royal_cav	Caballeros Hidalgos (Nobles)	true
land_units_onscreen_name_cha_spa_royal_guard_cavalry	Caballeros Del Rey (Royal Horsemen)	true
land_units_onscreen_name_cha_spa_royal_guardsmen	Espadachines Del Rey (Royal Swordsmen)	true
land_units_onscreen_name_cha_spa_royal_knights	Milites Hispaniarum (Spanish Knights)	true
land_units_onscreen_name_cha_spa_tribesmen	Bellatores Hispaniarum (Spanish Tribesmen)	true
land_units_onscreen_name_cha_vik_archers	Archers	true
land_units_onscreen_name_cha_vik_armoured_archers	Armoured Archers	true
land_units_onscreen_name_cha_vik_axe_freemen	Axe Freemen	true
land_units_onscreen_name_cha_vik_axe_hirdmen	Axe Hirdmen	true
land_units_onscreen_name_cha_vik_axe_throwers	Axe Throwers Hirdmen 	true
land_units_onscreen_name_cha_vik_axemen	Axemen	true
land_units_onscreen_name_cha_vik_berserkers	Berserkers	true
land_units_onscreen_name_cha_vik_big_axes	Big Axes	true
land_units_onscreen_name_cha_vik_heavy_raiders	Viking Heavy Raiders	true
land_units_onscreen_name_cha_vik_housecarls	Housecarls	true
land_units_onscreen_name_cha_vik_hunters	Viking Hunters	true
land_units_onscreen_name_cha_vik_levy_freemen	Levy Freemen	true
land_units_onscreen_name_cha_vik_marauders	Viking Marauders	true
land_units_onscreen_name_cha_vik_mounted_swords	Mounted Vikings	true
land_units_onscreen_name_cha_vik_onager	Onager	true
land_units_onscreen_name_cha_vik_onager_bastion	Bastion Onager	true
land_units_onscreen_name_cha_vik_raiders	Viking Raiders	true
land_units_onscreen_name_cha_vik_ship_archers	Viking Ship Archers	true
land_units_onscreen_name_cha_vik_skirm	Skirmishers	true
land_units_onscreen_name_cha_vik_smashers	Viking Smashers	true
land_units_onscreen_name_cha_vik_spear	Spearmen	true
land_units_onscreen_name_cha_vik_sword_freemen	Sword Freemen	true
land_units_onscreen_name_cha_vik_sword_hirdmen	Sword Hirdmen	true
land_units_onscreen_name_cha_vik_sword_raiders	Sword Hirdmen with Bows	true
land_units_onscreen_name_cha_vik_warlords_companions	Warlord's Companions	true
land_units_onscreen_name_cha_vik_warlords_companions_mounted	Mounted Warlord's Companions	true
